111111111111
10000100C001
10E000000001
100000C000C1
100001000001
10C00100P001
111111111111
