E11111111111
1P0001000001
10E000001101
101000C01001
111111111111
