11111111111111
10000100C00001
10E00000011001
100000C001C001
10000100010001
10C00100P00001
11111111111111
